Plate_well,row,column,Start residue,End residue,Sequence,fwd_primer_annealing,fwd_primer,fwd_primer_name,rev_primer_annealing,rev_primer,rev_primer_name,Construct_name
A01,A,01,50.0,73.0,SSSWSDSTAARHSRLESSDGDGA,TCTTCTTCTTGGTCTGATTCTACTGC,TATGGTCTCACGAGTCTTCTTCTTGGTCTGATTCTACTGC,fwd_primer_001,AGCACCATCACCATCAGAAGATTCTAAAC,TATGGTCTCAATGGCTAAGCACCATCACCATCAGAAGATTCTAAAC,rev_primer_001,constructx
A02,A,02,20.0,42.0,ADMKGHFDPAKCRYALGMQDRT,GCTGATATGAAAGGTCATTTTGATCCTG,TATGGTCTCACGAGGCTGATATGAAAGGTCATTTTGATCCTG,fwd_primer_002,AGTACGATCTTGCATACCTAAAGCATAAC,TATGGTCTCAATGGCTAAGTACGATCTTGCATACCTAAAGCATAAC,rev_primer_002,constructy
A03,A,03,20.0,73.0,ADMKGHFDPAKCRYALGMQDRTIPDSDISASSSWSDSTAARHSRLESSDGDGA,GCTGATATGAAAGGTCATTTTGATCCTG,TATGGTCTCACGAGGCTGATATGAAAGGTCATTTTGATCCTG,fwd_primer_002,AGCACCATCACCATCAGAAGATTCTAAAC,TATGGTCTCAATGGCTAAGCACCATCACCATCAGAAGATTCTAAAC,rev_primer_001,constructz
A04,A,04,,,,,,,,,,
A05,A,05,,,,,,,,,,
A06,A,06,,,,,,,,,,
A07,A,07,,,,,,,,,,
A08,A,08,,,,,,,,,,
A09,A,09,,,,,,,,,,
A10,A,10,,,,,,,,,,
A11,A,11,,,,,,,,,,
A12,A,12,,,,,,,,,,
B01,B,01,,,,,,,,,,
B02,B,02,,,,,,,,,,
B03,B,03,,,,,,,,,,
B04,B,04,,,,,,,,,,
B05,B,05,,,,,,,,,,
B06,B,06,,,,,,,,,,
B07,B,07,,,,,,,,,,
B08,B,08,,,,,,,,,,
B09,B,09,,,,,,,,,,
B10,B,10,,,,,,,,,,
B11,B,11,,,,,,,,,,
B12,B,12,,,,,,,,,,
C01,C,01,,,,,,,,,,
C02,C,02,,,,,,,,,,
C03,C,03,,,,,,,,,,
C04,C,04,,,,,,,,,,
C05,C,05,,,,,,,,,,
C06,C,06,,,,,,,,,,
C07,C,07,,,,,,,,,,
C08,C,08,,,,,,,,,,
C09,C,09,,,,,,,,,,
C10,C,10,,,,,,,,,,
C11,C,11,,,,,,,,,,
C12,C,12,,,,,,,,,,
D01,D,01,,,,,,,,,,
D02,D,02,,,,,,,,,,
D03,D,03,,,,,,,,,,
D04,D,04,,,,,,,,,,
D05,D,05,,,,,,,,,,
D06,D,06,,,,,,,,,,
D07,D,07,,,,,,,,,,
D08,D,08,,,,,,,,,,
D09,D,09,,,,,,,,,,
D10,D,10,,,,,,,,,,
D11,D,11,,,,,,,,,,
D12,D,12,,,,,,,,,,
E01,E,01,,,,,,,,,,
E02,E,02,,,,,,,,,,
E03,E,03,,,,,,,,,,
E04,E,04,,,,,,,,,,
E05,E,05,,,,,,,,,,
E06,E,06,,,,,,,,,,
E07,E,07,,,,,,,,,,
E08,E,08,,,,,,,,,,
E09,E,09,,,,,,,,,,
E10,E,10,,,,,,,,,,
E11,E,11,,,,,,,,,,
E12,E,12,,,,,,,,,,
F01,F,01,,,,,,,,,,
F02,F,02,,,,,,,,,,
F03,F,03,,,,,,,,,,
F04,F,04,,,,,,,,,,
F05,F,05,,,,,,,,,,
F06,F,06,,,,,,,,,,
F07,F,07,,,,,,,,,,
F08,F,08,,,,,,,,,,
F09,F,09,,,,,,,,,,
F10,F,10,,,,,,,,,,
F11,F,11,,,,,,,,,,
F12,F,12,,,,,,,,,,
G01,G,01,,,,,,,,,,
G02,G,02,,,,,,,,,,
G03,G,03,,,,,,,,,,
G04,G,04,,,,,,,,,,
G05,G,05,,,,,,,,,,
G06,G,06,,,,,,,,,,
G07,G,07,,,,,,,,,,
G08,G,08,,,,,,,,,,
G09,G,09,,,,,,,,,,
G10,G,10,,,,,,,,,,
G11,G,11,,,,,,,,,,
G12,G,12,,,,,,,,,,
H01,H,01,,,,,,,,,,
H02,H,02,,,,,,,,,,
H03,H,03,,,,,,,,,,
H04,H,04,,,,,,,,,,
H05,H,05,,,,,,,,,,
H06,H,06,,,,,,,,,,
H07,H,07,,,,,,,,,,
H08,H,08,,,,,,,,,,
H09,H,09,,,,,,,,,,
H10,H,10,,,,,,,,,,
H11,H,11,,,,,,,,,,
H12,H,12,,,,,,,,,,
